DDDDDDDDDDDDDDD
D-------A-----D
D-------------D
D-------------D
D-------R-----D
QQDQQDQQQDQQDQQ