DQQQQQQQQQQQQQD
D-----A-------D
D-------------D
Q--------QR---D
D-------QQ----D
D------------DD
QQQQQQQQDQQQDQQ