DDDDDDDDDDDDDDDD
D---Q-----Q----D
D---Q---A------D
D--------------D
D-----Q--Q-----D
D---------R----D
DDDDDDDDDDDDDDDD